30
3
2960
2720
2620
1970
1920
1840
1670
1630
1200
1180
------------------------------
------------------------------
--------------S---------------
------------------------------
-----XXXXXXXXXXXXXXXXXXX------
-----XOOOOOOOOOOOOOOOOOX------
-----XOOOOOOOOOOOOOOOOOX------
------OOOOOOOOOOOOOOOOOX------
------OOOOOOOOOOOOOOOOOX------
------OOOOOOOOOOOOOOOOOX------
------OOOOOOOOOOOOOOOOOX------
-------OOOOOO---OOOOOOOX------
------OOOOOOO---OOOOOOOX------
-------OOOO-------OOOOOX------
------OOOOO-------OOOOOX------
-------OOOOOO---OOOOOOOX------
------OOOOOOO---OOOOOOOX------
------OOOOOOOOOOOOOOOOOX------
------OOOOOOOOOOOOOOOOOX------
------OOOOOOOOOOOOOOOOOX------
------OOOOOOOOOOOOOOOOOX------
-----XOOOOOOOOOOOOOOOOOX------
-----XOOOOOOOOOOOOOOOOOX------
-----XXXXXXXXXXXXXXXXXXX------
------------------------------
---S--------------------S-----
------------------------------
------------------------------
------------------------------
------------------------------
