32
4
60
40
30
0
0
0
0
0
0
0
--------------------------------
--------------------------------
--XXX--XXX--XXX--XXX--XXX--XXX--
--X-X--X-X--X-X--X-X--X-X--X-X--
--XXXS-XXX--XXX--XXX--XXX-SXXX--
--------------------------------
--------------------------------
--XXX--X-X-XXXX--XXXXXXXX--XXX--
--X-X--X-X----X--X---------X-X--
--XXX--X-XXXX-X--X-XXXXXX--XXX--
-------X-X--X-X--X-X--X---------
-------X-X--X-X----X--X-X-------
--XXX--X-XXXX-X--XXXXXX-X--XXX--
--X-X--X----X-X---------X--X-X--
--XXX--XXXX-X-X--XXXXXXXX--XXX--
---------------OO---------------
---------------OO---------------
--XXX--XXXX-X-X--XXXXXXXX--XXX--
--X-X--X----X-X---------X--X-X--
--XXX--X-XXXX-X--XXXXXX-X--XXX--
-------X-X--X-X----X--X-X-------
-------X-X--X-X--X-X--X---------
--XXX--X-XXXX-X--X-XXXXXX--XXX--
--X-X--X-X----X--X---------X-X--
--XXX--X-X-XXXX--XXXXXXXX--XXX--
--------------------------------
--------------------------------
--XXX--XXX--XXX--XXX--XXX--XXX--
--X-X--X-X--X-X--X-X--X-X--X-X--
-SXXX--XXX--XXX--XXX--XXX--XXXS-
--------------------------------
--------------------------------
