20
2
700
270
220
220
140
140
120
120
110
110
--------------------
--------------------
--------------------
---------O----------
--------------------
--------------------
-XXXXXXXXXXXXXXXXXX-
------------------X-
-X-------O--------X-
-X----------------X-
-X-------O--------X-
-XO---O-O-O-O---O-X-
-X-------O--------X-
-X----------------X-
-X--S----O----------
-X-------------S--X-
-XXXXXXXX-XXXXXXXXX-
--------------------
--------------------
---------O----------
