32
4
470
340
250
160
50
40
40
30
20
10
XXXXXXXXXXXXXXXXXXXXXXXXXXXXXXXX
XXXXXXXXXXXXXXXXXXXXXXXXXXXXXXXX
X------------------------------X
X-XX------------------------XX-X
X-X--------------------------X-X
X---XXX------------------XXX---X
X---X----------------------X---X
X---X----------------------X---X
X------XXXXX---OO---XXXXX------X
X------XXXXX--------XXXXX------X
X--O---XXO------------OXX---O--X
X--O---XX-O----------O-XX---O--X
X--O---XX---X-XXXXXX---XX---O--X
X--O--------X------X--------O--X
X--O--------X-OOOO-X--------O--X
X--O--------X---------------O--X
X--O--------XXXXXXXX--------O--X
X--O---------------X--------O--X
X--O--------X-OOOO-X--------O--X
X--O--------X------X--------O--X
X--O---XX---XXXXXX-X---XX---O--X
X--O---XX-O----------O-XX---O--X
X--OS--XXO------------OXX--SO--X
X------XXXXX--------XXXXX------X
X------XXXXX--------XXXXX------X
X---X----------------------X---X
X---X----------------------X---X
X---XXX--------OO--------XXX---X
X-X--------------------------X-X
X-XX------------------------XX-X
X-----------S------S-----------X
XXXXXXXXXXXXXXXXXXXXXXXXXXXXXXXX
