15
2
0
0
0
0
0
0
0
0
0
0
---------------
---------------
------X--------
--S---X--------
------X--------
------X--------
------X--------
---XXXX--------
-----------S---
---------------
---------------
---O-----------
-------O-------
---------------
---------------
