30
3
380
370
310
190
150
140
130
120
110
100
------------------------------
------------------------------
------------------------------
------------------------------
------O-----------------------
----XXX-----------------O-----
----XX------------O---S-------
----X-X-----------------------
-------XOXXX-----XXX----------
--------XOOOX---XOOOX---------
-------XOOXOOX-XOOOOOX--------
-------XOXXOOOOOOOOOOX-----O--
-------XOOOOOOOOOOOOOX--------
--------XOOOOOOOOOOOX---------
---O-----XOOOOOOOOOX---O------
---S------XOOOOOOOX-----------
-----------XOOOOOXX-----------
------------XOOOXO-X----------
---X---O-----XOX----X---------
--XXX----------------XXX------
---X-----------------XX-------
-------O-------------X-X------
------------------------------
-------X---XXX-X-X-XXX--------
-O-----X---X-X-X-X-X----------
-------X---X-X-X-X-XXX--------
-------X--OX-X-X-X-X--O-------
-------XXX-XXX--X--XXX-----S--
------------------------------
------------------------------
