40
3
220
220
200
200
170
170
160
150
140
130
XX-----X---XXXXXXXXXXXXXX--------X-----X
XX-----X----------X--------------X-----X
XX-----X----------X--------------X-----X
XX-----X-----------------------O-X-----X
XX---O-X-------------------------X-----X
XX-----X-------O--O--------------X--O--X
XX-----X----------X--------------X-----X
XX-----X----------X--------------X-----X
XX-----X----------X--------------X-----X
X------XXXXXXX--XXX--O-----------X-----X
X--O---XX---------X------------S-X---XXX
X------XX---------XXXXXX----XXXXXX---XOX
X------------------------------------XOX
X------------------------------------XXX
X--------------------------------------X
X--XXX------XXXXXX--XXXXXX-------------X
X-------------------------X--------X---X
X------------------O------X-------X-X--X
X--XX----O--XXXXXX--XXXXXX------O-X-X-OX
X-X--X----------------------------X-X--X
X--XX-----------------------------X-X--X
X---------------XXXXXXXXXXXXXX-----X---X
X--------------X-OOOOO--------X--------X
X--------X-----X-OOOOO--------X--------X
X--------X------XXXXXXXXXXXXXX-------XXX
X---------X--------------------------XXX
X--O------X--------------------------XXX
X-------------O----------------------XXX
XXX----------------------------X-------X
XX-----XXXXX----XXXXXXXXX-----X-X------X
XX-----X----------------X-----X-X------X
XX-----X----------------XX--XXXXXX-----X
XX-----X----------------X--O-----X-----X
XX-----X-----------O----X--------X--O--X
XX-----X----------------X--------X-----X
XX-----X----------------X--------X-----X
XX-----X------S---------XXXXXX---X-----X
XX-----X-------------------------------X
XX--S--X--------------------O----------X
XX-----X---XXXXXXXXXXXXXX--------------X
