35
4
320
210
180
160
110
100
90
30
20
0
XXXXXXXXXXXXXXXXXXXXXXXXXXXXXXXXXXX
----------------------X------------
----------------------X------------
----------------------X-------O----
----------------------X------O-O---
-----------------O----X-------O----
X-------S-------O-O---X----S------X
X----------------O----X-----------X
X----O----------------X-----------X
X---O-O---------------X-----------X
X----O----------------X-----------X
X---------------------X-----------X
X---------------------X-----------X
XXXXXXXXXXXXXXXXX-----XXXXXXXXXXXXX
----------------X------------------
O---------------X-----------------O
OO--------------X----------------OO
O---------------X-----------------O
----------------X------------------
XXXXXXXXXXX-----XXXXXXXXXXXXXXXXXXX
----------X------------------------
----------X-----------------O------
----------X----------------O-O-----
----O-----X-----------------O------
---O-O----X------O-----------------
----O-----X-----O-O----------------
X-------S-X------O---------S------X
X---------X-----------------------X
X---------X-----------------------X
X---------X-----------------------X
X---------X-----------------------X
X---------X-----------------------X
XXXXXXXXXXXXXXXXXXXXXXXXXXXXXXXXXXX
XXXXXXXXXXXXXXXXXXXXXXXXXXXXXXXXXXX
-----------------------------------
