32
3
220
140
120
100
50
50
40
30
30
30
---------------X----------------
---------------X----------------
---------------X----------------
---------------X----------------
---------------X----------------
---------------X----------------
---------------X----------------
---------------X----------------
--------S------X----------------
---------XXX---X---XXX----------
---------XO----X----OX----------
---------X-----X-----X----------
---------------X----------------
---------------X----------------
--------------OXO---------------
XXXXXXXXXXXXXXXXXXXXXXXXXXXXXXXX
--------------OXO---------------
---------------X----------------
---------------X----------------
---------X-----X-----X----------
---------XO----X----OX----------
---------XXX---X---XXX----------
---------------X------S---------
---------------X----------------
---XXX---------X-----------S----
---OO----------X----------------
--XXXXX--------X----------------
---X-----------X----------------
---X-----------X----------------
---X-----------X----------------
---------------X----------------
---------------X----------------
