10
2
60
40
0
0
0
0
0
0
0
0
----------
----O-----
----------
---XXX----
-O-X-X-O--
---XXX----
----------
-S--O--S--
----------
----------
